111111111111111111111
10001E1000000C00C0001
1010000100100B0010101
101001B010101010B0101
1P00100000000B0000001
111111111111111111111
