1111111111111111111111111111111111
10001E1100000C00C00000000000000001
1010000100100000101001010000010101
10100100101010100010010100C0010101
1P00100000000000000001010001000001
1111111111111111111111111111111111
